##########
#S.C....E#
#..#C.#..#
#........D
##########